{
	"numTilesX": 15,
	"numTilesY": 11,
	"size": [64, 64],
	"start": [-32, -32],
	"tileNames": ["", "tile01", "tile02", "tile03"],
	"tiles": [
				3, 3, 3, 3, 3, 3, 3, 3, 3, 3, 3, 3, 3, 3, 3,
				3, 0, 0, 0, 0, 0, 0, 0, 0, 0, 0, 0, 0, 0, 3,
				3, 0, 0, 0, 0, 0, 0, 0, 0, 0, 0, 0, 0, 0, 3,
				3, 0, 0, 0, 0, 0, 0, 0, 0, 0, 0, 0, 0, 0, 3,
				3, 0, 0, 0, 0, 0, 0, 0, 0, 0, 0, 0, 0, 0, 3,
				3, 0, 0, 0, 0, 0, 0, 0, 0, 0, 0, 0, 0, 0, 3,
				3, 0, 0, 0, 0, 0, 2, 2, 2, 2, 0, 0, 0, 0, 3,
				3, 0, 2, 2, 0, 0, 0, 0, 0, 0, 0, 2, 2, 0, 3,
				3, 0, 0, 0, 0, 0, 0, 0, 0, 0, 0, 0, 0, 0, 3,
				1, 1, 1, 1, 1, 1, 1, 1, 1, 1, 1, 1, 1, 1, 1,
				1, 1, 1, 1, 1, 1, 1, 1, 1, 1, 1, 1, 1, 1, 1
			  ]
}